Generated by ChatGpt

DOM Basics:

Document Object: document
Access Element by ID: document.getElementById("elementId")
Access Elements by Tag Name: document.getElementsByTagName("tag")
Access Elements by Class Name: document.getElementsByClassName("class")
Query Selector: document.querySelector("selector")
Query Selector All: document.querySelectorAll("selector")


Element Properties:

Inner HTML: element.innerHTML
Text Content: element.textContent
Attribute Value: element.getAttribute("attribute")
Set Attribute: element.setAttribute("attribute", "value")


Manipulating Elements:

Create Element: document.createElement("tag")
Append Child: parent.appendChild(child)
Remove Child: parent.removeChild(child)
Replace Child: parent.replaceChild(newChild, oldChild)


Style Manipulation:

Inline Styles: element.style.property = "value"
Add Class: element.classList.add("class")
Remove Class: element.classList.remove("class")
Toggle Class: element.classList.toggle("class")


Event Handling:

Add Event Listener: element.addEventListener("event", function)
Remove Event Listener: element.removeEventListener("event", function)


Traversal:

Parent Node: element.parentNode
Child Nodes: element.childNodes
Next Sibling: element.nextSibling
Previous Sibling: element.previousSibling


DOM Events:

Click Event: click
Mouse Over Event: mouseover
Mouse Out Event: mouseout
Key Down Event: keydown
Submit Event: submit


Document Navigation:

Document URL: document.URL
Document Title: document.title
Forms Collection: document.forms
Images Collection: document.images
Links Collection: document.links